w w w w w w w w w w w w w w w w w w w w w w w w w w w w
w p p p p p p p p p p p p w w p p p p p p p p p p p p w
w p w w w w p w w w w w p w w p w w w w w p w w w w p w
w Q w B B w p w B B B w p w w p w B B B w p w B B w Q w
w p w w w w p w w w w w p w w p w w w w w p w w w w p w
w p p p p p p p p p p p p p p p p p p p p p p p p p p w
w p w w w w p w w p w w w w w w w w p w w p w w w w p w
w p w w w w p w w p w w w w w w w w p w w p w w w w p w
w p p p p p p w w p p p p w w p p p p w w p p p p p p w
w w w w w w p w w w w w n w w n w w w w w p w w w w w w
B B B B B w p w w w w w n w w n w w w w w p w B B B B B
B B B B B w p w w n n n n n n n n n n w w p w B B B B B
B B B B B w p w w n w w w D D w w w n w w p w B B B B B
w w w w w w p w w n w G G G G G G w n w w p w w w w w w
W B B B B B p n n n w G G G G G G w n n n p B B B B B W
w w w w w w p w w n w G G G G G G w n w w p w w w w w w
B B B B B w p w w n w G G G G G G w n w w p w B B B B B
B B B B B w p w w n w w w w w w w w n w w p w B B B B B
B B B B B w p w w n n n n n n n n n n w w p w B B B B B
w w w w w w p w w n w w w w w w w w n w w p w w w w w w
w p p p p p p p p p p p p w w p p p p p p p p p p p p w
w p w w w w p w w w w w p w w p w w w w w p w w w w p w
w Q w w w w p w w w w w p w w p w w w w w p w w w w Q w
w p p p w w p p p p p p p S p p p p p p p p w w p p p w
w w w p w w p w w p w w w w w w w w p w w p w w p w w w
w w w p w w p w w p w w w w w w w w p w w p w w p w w w
w p p p p p p w w p p p p w w p p p p w w p p p p p p w
w p w w w w w w w w w w p w w p w w w w w w w w w w p w
w p w w w w w w w w w w p w w p w w w w w w w w w w p w
w p p p p p p p p p p p p p p p p p p p p p p p p p p w
w w w w w w w w w w w w w w w w w w w w w w w w w w w w