w w w w w w w w w w w w w w w w w w w w w w w w w w w w
w p p p p p p p p p p p p B B p p p p p p p p p p p p w
w p B B B B p B B B B B p B B p B B B B B p B B B B p w
w Q B B B B p B B B B B p B B p B B B B B p B B B B Q w
w p B B B B p B B B B B p B B p B B B B B p B B B B p w
w p p p p p p p p p p p p p p p p p p p p p p p p p p w
w p B B B B p B B p B B B B B B B B p B B p B B B B p w
w p B B B B p B B p B B B B B B B B p B B p B B B B p w
w p p p p p p B B p p p p B B p p p p B B p p p p p p w
w w w w w w p B B B B B p B B p B B B B B p w w w w w w
B B B B B w p B B B B B p B B p B B B B B p w B B B B B
B B B B B w p B B p p p p p p p p p p B B p w B B B B B
B B B B B w p B B p w w w D D w w w p B B p w B B B B B
w w w w w w p B B p w G G G G G G w p B B p w w w w w w
W B B B B B p p p p w G G G G G G w p p p p B B B B B W
w w w w w w p b b p w G G G G G G w p B B p w w w w w w
B B B B B w p b b p w G G G G G G w p B B p w B B B B B
B B B B B w p b b p w w w w w w w w p B B p w B B B B B
B B B B B w p b b p p p p p p p p p p B B p w B B B B B
w w w w w w p b b p B B B B B B B B p B B p w w w w w w
w p p p p p p p p p p p p B B p p p p p p p p p p p p w
w p B B B B p B B B B B p B B p B B B B B p B B B B p w
w Q B B B B p B B B B B p B B p B B B B B p B B B B Q w
w p p p B B p p p p p p p p p p p p p p p p B B p p p w
w B B p B B p B B p B B B B B B B B p B B p B B p B B w
w B B p B B p B B p B B B B B B B B p B B p B B p B B w
w p p p p p p B B p p p p B B p p p p B B p p p p p p w
w p B B B B B B B B B B p B B p B B B B B B B B B B p w
w p B B B B B B B B B B p B B p B B B B B B B B B B p w
w p p p p p p p p p p p p p p p p p p p p p p p p p p w
w w w w w w w w w w w w w w w w w w w w w w w w w w w w